1111111111111
1C01C000000C1
100C0111C1001
1P0001E0000C1
1111111111111