11111111111111111111111111111111111111111111111111111111111111111
1C01C000000C00000000000000000000000000000000000000000000000000001
100C0111C10000000000000000000000000000000000000000000000000000001
1P0001E0000C00000000000000000000000000000000000000000000000000001
11111111111111111111111111111111111111111111111111111111111111111
