111111111111111111
1C01C00000C0000001
100C0111C100000001
1P0001E0000E000001
100000000000000001
111111111111111111